{
    "a":"c4",
    "b":"g4",
    "c":"k4",
    "d":"c8",
    "e":"g8",
    "f":"k8",
    "g":"c10"
}